##########
#S#   #  #
# # # ## #
# # #    #
# # # ####
#   #    #
### # ####
#   #   A#
# ###### #
##########