##########
#S   #   #
### ### ##
#     #  #
# ### ####
#   #    #
### #### #
#     #  #
# ###   A#
##########