##########
#S#   #  #
# # # ## #
# # #    #
# ### ####
#   #    #
### # ####
#   #   A#
# ###### #
##########