##########
#S#   #  #
# # # ## #
# # #    #
# # ######
# #      #
# ###### #
#        #
###### #A#
##########