##########
#S     # #
### ### # #
#   #   # #
# ### ### #
#   #     #
### #######
#         #
# #######A#
##########