##########
#S     # #
# #### # #
# #    # #
# # #### #
# #      #
# ###### #
#      # #
###### #A#
######   #