##########
#S#   #  #
# # # ## #
# # #    #
# # ######
# #      #
# ###### #
#      # #
###### #A#
##########