##########
#S     # #
# #### # #
#    # # #
#### # # #
#    #   #
# ####### 
#       #
# #####A#
##########