##########
#S     ###
### ###  #
#   #    #
# ### ####
#   #    #
### #### #
#     #  #
# ###   A#
##########