##########
#S#   #  #
# # # ## #
#   #    #
### ######
#        #
###### # #
#      # #
# ######A#
##########