##########
#S#      #
# # ######
# #      #
# ###### #
#      # #
###### # #
#      # #
# ######A#
##########