##########
#S     # #
# #### # #
#    # # #
#### # # #
#    #   #
# ########
#       ##
# #####A##
##########