##########
#S#     ##
# # ###  #
# #   # ##
# ### #  #
#   # ## #
### #    #
#   #### #
#      A #
##########